NO ./images/bleu.xpm
EA ./images/coffee.xpm
SO ./images/black.xpm
WE ./images/purple.xpm

C 234,198,150
F 101, 69, 0

        
1111111111111111
1000000000000001
1000001000000001
1000000000000001
1000000000000001
100010W000000001
1000000000000001
1000000000000001
1000000000000001
1111111111111111