1111111111111
1000000000001
1011111110101
1001101110001
100N001010101
1010111010101
1010100000101
1011111111101
1011111111101
1000011000101
1011111111101
1000000000001
1111111111111