NO   ./path_to_the_north_texture   
SO ./path_to_the_south_texture 

    WE    ./path_to_the_west_texture
	F 20 , 100 , 52
EA		./path_to_the_east_texture
	

 C 225	,30,0 
   
    
1111111111111
1000000000001
1011111110101
1001101110001
100S001010101
101011101001
10101  10001
101111111101
101111111101
100001110001
1011111 11101
1000001 10001
1111111 11111