 
   NO   ./path_to_the_north_texture   
SO ./path_to_the_south_texture 

    WE    ./path_to_the_west_texture
EA		./path_to_the_east_texture
	
	F 20 , 100 , 52

 C 225	,30,251		 

111111111 11
100000010101
111111111101
1 111111101  
110N11101101
11111 11 111