NO   ./path_to_the_north_texture   
SO ./path_to_the_south_texture 

    WE    ./path_to_the_west_texture
	F 20 , 100 , 52
EA		./path_to_the_east_texture
	

 C 225	,30,0 
   
    
11111111
10000001
10000001
10000001
10000001
10000001
1000N001
11111111