NO ./images/1.xpm
EA ./images/4.xpm
SO ./images/2.xpm
WE ./images/3.xpm

C 234, 198, 150
F 101, 69, 0

1111111111111
1000000000001
1000W00100001
1000000000001
1111111111111