NO   ./path_to_the_north_texture   
SO ./path_to_the_south_texture 

    WE    ./path_to_the_west_texture
	F 20 , 100 , 52
EA		./path_to_the_east_texture
	

 C 000	,0,250 
   
    
11111111
10000001
10001001
10010001
10001001
10010001
10001001
10000001
1000E001
10000001
10000001
11111111