NO ./images/1.xpm
EA ./images/4.xpm
SO ./images/2.xpm
WE ./images/3.xpm

C 234, 198, 150
F 101, 69, 0

111111111111111111111111111111111111111
100000000000000000000000000000000000001
1000000000000000000000000000000000S0001
111111111111111111111111111111111111111