NO ./images/1.xpm
EA ./images/1.xpm
SO ./images/1.xpm
WE ./images/2.xpm

C 234,198,150
F 101, 69, 0

        
1111111111111111
1000000000000001
100000W000000001
1000000000000001
1111111111111111