1111111111111
1000000000001
1011111110101
1011101110001
100N111010101
1011111010101
1011100000101
1011111111101
1011111111101
1000011000101
1011111111101
1000000000001
1111111111111