NO   ./images/1.xpm
SO ./images/2.xpm
WE    ./images/3.xpm
EA		./images/4.xpm
	
C 234, 198, 150
F 101, 69, 31
    
11111111
10000001
100010011111111111111111
1000000000001111111111111
1000000000000011111111111
1000N00000000011111
10001001111111
10000000000001
10000000000001
10000000000001
10000000000001
10001001111111111
11111111