NO   ./images/1.xpm
SO ./images/2.xpm
WE    ./images/3.xpm
EA		./images/4.xpm
	
C 234, 198, 150
F 101, 69, 31
    
11111111
10000001
1000100111
10010000001
10001000001
10010000001
10001000001
10000000001
1000E00111
10000001
10000001
11111111