NO   ./images/1.xpm
SO ./images/2.xpm
WE    ./images/3.xpm
EA		./images/4.xpm
	
C 234, 198, 150
F 101, 69, 31
    
1111111111111111
1000000000000011
1000100000001011
1000000000000011
1000000000000011
1000N00000000011
1000100000001011
1111111111111111