NO   ./images/1.xpm
SO ./images/2.xpm
WE    ./images/3.xpm
EA      ./images/4.xpm
	
C 234, 198, 150
F 101, 69, 31
    
11111111111111111
10000100000000001
1000110001001100111111111111111111111111111111111
100000000000000000000000000000000000000000001
100000000000000000000000000000000000000000001
10000000S000000000000000000000000000000000001
100000000100000000000000000000000000000000001
100000001000000000000000000000000000000000001
100000000000000000000000000000000000000000001
100000000000000000000000000000000000000000001
100000000000000000000000000000000000000000001
100000000000000000000000000000000000000000001
100000000000000000000000000000000000000000001
100000000000000000000000000000000000000000001
100000000000000000000000000000000000000000001
100000000000000000000000000000000000000000001
100000000000000000000000000000000000000000001
100000000000000000000000000000000000000000001
100000000000000000000000000000000000000000001
100000000000000000000000000000000000000000001
100000000000000000000000000000000000000000001
100000000000000000000000000000000000000000001
100000000000000000000000000000000000000000001
100000000000000000000000000000000000000000001
100000000000000000000000000000000000000000001
100000000000000000000000000000000000000000001
100000000000000000000000000000000000000000001
100000000000000000000000000000000000000000001
100000000000000000000000000000000000000000001
100000000000000000000000000000000000000000001
100000000000000000000000000000000000000000001
1111111111111111111111111111111111111111111111111