NO   ./images/1.xpm
SO ./images/2.xpm
WE    ./images/3.xpm
EA		./images/4.xpm
	
C 234, 198, 150
F 101, 69, 31
    
1111111111111111111111111
1000010000000011100000011
100011000100101110001001 
10000111111111011111111
1000010W000000011
10000101111111011111
10001100010010111000111
1111111111111111111111111