NO ./images/1.xpm
SO ./images/2.xpm
WE ./images/3.xpm
EA ./images/4.xpm

C 1,1,1
F 1,1,1


1111111
1111111
11111111111111
111N0111
11111111111111