NO   ./images/1.xpm
SO ./images/2.xpm
WE    ./images/3.xpm
EA      ./images/4.xpm
	
C 234, 198, 150
F 101, 69, 31
    
111111111111111
100000100000001
100S011111111111111111111
10000011000000000000010001
10000010000000000000000001
1111111111111111111111111